1111111111111111111111111
10000000000000000000010E1
1000C0000000000C000001001
1000000000000011111001001
10000C000000001C011001001
100000000000001000C000001
111111C011100011111110111
1P0000000010001C0000C0001
1111111111111111111111111